╔═══════╦═══════╦═══════╗
║ 3 2 6 ║ 1 4 5 ║ 9 8 7 ║
║ 8 5 1 ║ 7 3 9 ║ 2 6 4 ║
║ 4 9 7 ║ 6 2 8 ║ 5 1 3 ║
╠═══════╬═══════╬═══════╣
║ 2 6 4 ║ 9 8 7 ║ 3 5 1 ║
║ 9 7 8 ║ 3 5 1 ║ 4 2 6 ║
║ 5 1 3 ║ 2 6 4 ║ 8 7 9 ║
╠═══════╬═══════╬═══════╣
║ 6 8 5 ║ 4 1 3 ║ 7 9 2 ║
║ 7 4 2 ║ 5 9 6 ║ 1 3 8 ║
║ 1 3 9 ║ 8 7 2 ║ 6 4 5 ║
╚═══════╩═══════╩═══════╝

╔═══════╦═══════╦═══════╗
║ 2 6 4 ║ 8 3 5 ║ 7 1 9 ║
║ 5 7 8 ║ 6 9 1 ║ 2 4 3 ║
║ 3 1 9 ║ 2 4 7 ║ 5 8 6 ║
╠═══════╬═══════╬═══════╣
║ 6 2 3 ║ 9 7 4 ║ 1 5 8 ║
║ 4 9 7 ║ 1 5 8 ║ 6 3 2 ║
║ 8 5 1 ║ 3 6 2 ║ 4 9 7 ║
╠═══════╬═══════╬═══════╣
║ 1 8 6 ║ 4 2 9 ║ 3 7 5 ║
║ 7 4 2 ║ 5 8 3 ║ 9 6 1 ║
║ 9 3 5 ║ 7 1 6 ║ 8 2 4 ║
╚═══════╩═══════╩═══════╝

